####################
#?...~~~~~~........#
#....~~~~~~........#
#....######~~~~~~~~#
#....#..@.#~~~~~~~~#
#.........#~~~~~~~~#
###########........#
          #.@......#
          #........########################################################################################################################
          #~~~~~~~~#......................................................................................................................#
          #~~~~~~~~#.....#................................................................................................................#
          #~~~~~~~~#.....#................................................................................................................#
          #~~~~~~~~#.....############################################################################################################.....#
          #~~~~~~~~#.....#..........................................................................................................#.....#
          #~~~~~~~~#.....#..........................................................................................................#.....#
          #~~~~~~~~#.....#..........................................................................................................#.....#
          #~~~~~~~~#.....#....##################################################################################################....#.....#
          #~~~~~~~~#.....#....#.....................................................................................................#.....#
          #~~~~~~~~#.....#....#.....................................................................................................#.....#
          #........#.....#....#.....................................................................................................#.....#
          #...@....#.....#....#.....................................................................................................#.....#
          #.@......#.....#....#.....................................................................................................#.....#
          #........#.....#....#.....................................................................................................#.....#
          #~~~~~~~~#.....#....#.....................................................................................................#.....#
          #~~~~~~~~#.....#....#.....................................................................................................#.....#
          #~~~~~~~~#.....#....#.....................................................................................................#.....#
          #~~~~~~~~#.....#....#.....................................................................................................#.....#
          #~~~~~~~~#.....#....#.....................................................................................................#.....#
          #~~~~~~~~#.....#....#.....................................................................................................#.....#
          #~~~~~~~~#.....#....#.....................................................................................................#.....#
          #~~~~~~~~#.....#....#.....................................................................................................#.....#
          #~~~~~~~~#.....#..~~#.....................................................................................................#.....#
          #~~~~~~~~#.....#....#.....................................................................................................#.....#
          #~~~~~~~~#.....#....#.....................................................................................................#.....#
          #........#.....#....#.....................................................................................................#.....#
          #...@....#.....#....#.....................................................................................................#.....#
          #..............#....#.....................................................................................................#.....#
          #..............#....#.....................................................................................................#.....#
          #..............#....#.....................................................................................................#.....#
          #..............#....#.....................................................................................................#.....#
          #..............#....#.....................................................................................................#.....#
          #..............#....#.....................................................................................................#.....#
          #..............#....#.....................................................................................................#.....#
          #..............#....#.....................................................................................................#.....#
          #..............#....#.....................................................................................................#.....#
          #..............#....#.....................................................................................................#.....#
          #..............#....#.....................................................................................................#.....#
          #..............#....#.....................................................................................................#.....#
          #..............#....#.....................................................................................................#.....#
          #..............#....#.....................................................................................................#.....#
          #..............#....#######################################################################################################.....#
          #..............#...............................................................................................................#
          #......?.......#...............................................................................................................#
          #################################################################################################################################